
.    1




. @@@@@@@
..#######
..@@@....@@@@@@@
.........######@
.........#######
.........#######
.........#######
.........#######
.........#######
.........#######
.........#######
.........#######
.........#######
.........#######
.........#######
.........#######
.........#######
.........#######
.........#######
.........#######
.........#######
.........#######
.........#######
.........#######
.........#######
.........#######
........@#######
.......@@#######              @     @  2
....@@@@@#######@@@@@@@@@@@@@@@@@@@@@@@@@
#########################################
#########################################
#########################################