.
.
.         1
.
.

.        @@@@
.        ####
.
.
.
.

.    @@@@    @@@@
.    ####    ####
.
.
.
.

.        @@@@    @@@@
.        ####    ####
.
.
.
.
.    @@@@
.    ####
.
.
.
.

@        2   @                 @
@@@@@@@@@@@@@@@@@@@@@@@ @@@@@@@@@@@@@@@@@@@@
######@@@@@@@@@@@@@@@@@@@@@@@@@@@@@@@@######
#########################@@@@###############
############################################