.##################################.
######################################.
######                             @###
#####   1                            @##
####                                  ##
####                                  ##
####                                  ###
####                                  ###
####                                  ###
####                                  ####
####                                  ####
####@                                @####
#####@                              @#####
######@          @               @@@######
######@@@@@@@@@@@@@@@@@@ @@@@@@@@@@########
#######@@@@@@@@@@@@@@@@@@@@@@@@@@##########
############@@@@@@##########################
############################################
#############################################
#############################################
#############################################
#############################################
############################################
############################################
############################################
###########################################
########################........###########
###################...............########
##############......................######
######..............................######
####..................................###
####                                  ###
####                                  ###
####                                  ###
####@                                 ##
####@@@@     @             2        @@##
####@@@@@@@@@@@@@@ @@@@@@@@@@@@@@@@@@@##
##################@#####################
#######################################
#######################################
################################
..###########################
....######################
......###############
