.##################################.
##############             ###########.
######                             @###
#####   1                           @@##
###@                                  ##
###                                   ##
###                                   @##
###                                    ##
###@                                   ##
####                                   ###
####                                  @###
####@                                @####
#####@                              @#####
######@          @               @@@######
######@@@@@@@@@@@@@@@@@@ @@@@@@@@@@########
#######@@@@@@@@@@@@@@@@@@@@@@@@@@##########
############@@@@@@##########################
############################################
#############################################
#############################################
#############################################
#############################################
############################################
############################################
############################################
###########################################
########################........###########
###################...............########
##############......................######
#########...........................######
######................................###
####..................................###
###...................................###
###                                   ###
####@                                 ##
####@@@@     @             2        @@##
####@@@@@@@@@@@@@@ @@@@@@@@@@@@@@@@@@@##
#########@@@@@@@@@@@@@@@@@@@@@@#########
################@@@@@@##################
#######################################
################################
..###########################
....######################
......###############
